#################################################
#......# ..   ..............    #####  # .... #.#
#..#####    # ###       # ####### ....... # ... #
#...# ..... #   ########  ........  ########### #
#   #### ####          ###### ########.... # ...#
# . #    ............            #   #          #
#   ##############    #######    #   #########  #
#  .       .   . #   .......     #              #
#   ######### ##########  ########  ##   ###    #
#........#............................. ##...   #
#################################################
